## #######
##     ###
#  ### ###
# ####   #
#    ### #
#### ### #
#    #    
# #### ###
#        #
###### ###
