## ### ###
#    # # #
# ## #   #
# #  # # #
# #  # # #
# ## #   #
#    # # #
# ## # # #
#    # # #
###### ###
