## ### ###
#        #
#        #
#        #
#        #
#        #
#    # # #
# ## # # #
#    # # #
###### ###
