## ### ###
#    # # #
#    #   #
# #  # # #
# #  # # #
# ## #   #
#      # #
#    # # #
#    # # #
###### ###
