## ### ###
#      # #
# ## #   #
# #      #
# #  #   #
# ## #   #
#        #
# ## # # #
#    # # #
###### ###
